%%%%%%%%%%%%%%%%%%%%
%                  %
%                  %
%                  %
%        %         %
%                  %
%                  %
%                  %
%     G            %
%                  %
%       P  G       %
%    G             %
%                  %
%                  %
%                  %
%                  %
%                . %
%                  %
%                  %
%%%%%%%%%%%%%%%%%%%%
